|------------------------------------------------------------------------------------------|
|                                                                                          |
|   |----------|      |----------|      |----------|   #  |----------|      |----------|   |
|   |..........+######+..........|      |..........|   ###+..........|  ####+..........|   |
|   |..........|  #   |..........|      |..........|   #  |..........|  #   |..........|   |
|   |..........|  #   |..........|      |..........|   #  |..........|  #   |..........|   |
|   |..........|  #   |.......@..|  ####+..........|   #  |..........|  #   |..........|   |
|   |..........|  #   |..........|  #   |..........|   #  |..........|  #   |..........|   |
|   |----+-----|  #   |----------|  #   |--------+-|   #  |----+-----|  #   |-+------+-|   |
|        #        #                 #            #     #       #        #     #      #     |
|        #        ###################     #      #     #########        #     #      #     |
|        #                 #        #     #            #       #        #     #      #     |
|   |----+-----|      |----+-----|  #   |-+--------|      |----+-----|  #   |-+------+-|   |
|   |..........|      |..........|  ####+..........+######+..........|  #   |..........|   |
|   |..........|      |..........|      |..........|      |..........|  #   |..........|   |
|   |..........+####  |..........|      |..........|   #  |..........|  #   |..........|   |
|   |..........|   #  |..........|      |..........|   #  |..........|  #   |..........|   |
|   |..........|   #  |..........|  ####+..........|   #  |..........|  #   |..........|   |
|   |----------|   #  |-+------+-|  #   |----+-----|   #  |----------|  #   |-+------+-|   |
|                  #    #      #    #        #         #                #     #      #     |
| ################ ######### ########        #         ##################     #  ######### |
| #              #         #        #        #         #                #        #       # |
| # |----------| #    |----+-----|      |----+-----|   #  |----------|  #   |----+-----| # |
| # |..........| #    |..........|  #   |..........+######+..........|  #   |..........| # |
| # |..........| #    |..........|  #   |..........|      |..........|      |..........| # |
| # |..........| #  ##+..........+######+..........| ###  |..........+######+..........| # |
| ##+..........+##  # |..........|  #   |..........|   #  |..........|      |..........| # |
| # |..........| #  # |..........|  #   |..........|   #  |..........|      |..........| # |
| # |----------| #  # |----------|  #   |-----+----|   #  |----------|      |----+-----| # |
| #                 #               #         #        #                         #       # |
| ################################### ################ ###########################       # |
|        #        #                 #         #        #                 #               # |
|   |----+-----|  #   |----------|  #   |-----+----|   #  |----------|   #  |----------| # |
|   |..........+###   |..........|  #   |..........|   #  |..........|   #  |..........| # |
|   |..........|      |..........|      |..........|   #  |..........|   #  |..........| # |
|   |..........|      |..........+###   |..........|   ###+..........| #### |..........| # |
|   |..........|      |..........|  #   |..........|      |.......\..|      |..........| # |
|   |..........+######+..........|  ####+..........|      |..........|      |..........+## |
|   |----------|      |----------|      |----------|      |----------|      |----------|   |
|                                                                                          |
|------------------------------------------------------------------------------------------|