|---------------------------------------------------|
|                                                   |
|                 |---------------|                 |
|                 |...............|                 |
|     |-----------|...............|-----------|     |
|     |.......................................|     |
|     |.......................................|     |
|     |.......................................|     |
|     |............|------+------|............|     |
|     |............|      #      |............|     |
|     |............| |----+----| |............|     |
|     |............| |.........| |............|     |
|     |............| |.........| |............|     |
|     |............| |.........| |............|     |
|     |............| |.........| |............|     |
|     |............+#+.........+#+............|     |
|     |............| |.........| |............|     |
|     |............| |.........| |............|     |
|     |............| |.........| |............|     |
|     |............| |.........| |............|     |
|     |............| |.........| |............|     |
|     |............| |----+----| |............|     |
|     |............|      #      |............|     |
|     |............|------+------|............|     |
|     |.......................................|     |
|     |.......................................|     |
|     |-----------|...............|-----------|     |
|                 |...............|                 |
|                 |---------------|                 |
|                                                   |
|---------------------------------------------------|
|---------------------------------------------------|
|                                                   |
|                 |---------------|                 |
|                 |...............|                 |
|     |-----------|...............|-----------|     |
|     |.......................................|     |
|     |.......................................|     |
|     |.......................................|     |
|     |............|------+------|............|     |
|     |............|      #      |............|     |
|     |............| |----+----| |............|     |
|     |............| |.........| |............|     |
|     |............| |.........| |............|     |
|     |............| |.........| |............|     |
|     |............| |.........| |............|     |
|     |............+#+.........+#+............|     |
|     |............| |.........| |............|     |
|     |............| |.........| |............|     |
|     |............| |.........| |............|     |
|     |............| |.........| |............|     |
|     |............| |.........| |............|     |
|     |............| |----+----| |............|     |
|     |............|      #      |............|     |
|     |............|------+------|............|     |
|     |.......................................|     |
|     |.......................................|     |
|     |-----------|...............|-----------|     |
|                 |...............|                 |
|                 |---------------|                 |
|                                                   |
|---------------------------------------------------|
|---------------------------------------------------|
|                                                   |
|                 |---------------|                 |
|                 |...............|                 |
|     |-----------|...............|-----------|     |
|     |.......................................|     |
|     |.......................................|     |
|     |.......................................|     |
|     |............|------+------|............|     |
|     |............|      #      |............|     |
|     |............| |----+----| |............|     |
|     |............| |.........| |............|     |
|     |............| |.........| |............|     |
|     |............| |.........| |............|     |
|     |............| |.........| |............|     |
|     |............+#+.........+#+............|     |
|     |............| |.........| |............|     |
|     |............| |.........| |............|     |
|     |............| |.........| |............|     |
|     |............| |.........| |............|     |
|     |............| |.........| |............|     |
|     |............| |----+----| |............|     |
|     |............|      #      |............|     |
|     |............|------+------|............|     |
|     |.......................................|     |
|     |.......................................|     |
|     |-----------|...............|-----------|     |
|                 |...............|                 |
|                 |---------------|                 |
|                                                   |
|---------------------------------------------------|
|---------------------------------------------------|
|                                                   |
|                 |---------------|                 |
|                 |...............|                 |
|     |-----------|...............|-----------|     |
|     |.......................................|     |
|     |.......................................|     |
|     |.......................................|     |
|     |............|------+------|............|     |
|     |............|      #      |............|     |
|     |............| |----+----| |............|     |
|     |............| |.........| |............|     |
|     |............| |.........| |............|     |
|     |............| |.........| |............|     |
|     |............| |.........| |............|     |
|     |............+#+.........+#+............|     |
|     |............| |.........| |............|     |
|     |............| |.........| |............|     |
|     |............| |.........| |............|     |
|     |............| |.........| |............|     |
|     |............| |.........| |............|     |
|     |............| |----+----| |............|     |
|     |............|      #      |............|     |
|     |............|------+------|............|     |
|     |.......................................|     |
|     |.......................................|     |
|     |-----------|...............|-----------|     |
|                 |...............|                 |
|                 |---------------|                 |
|                                                   |
|---------------------------------------------------|
|---------------------------------------------------|
|                                                   |
|                 |---------------|                 |
|                 |...............|                 |
|     |-----------|...............|-----------|     |
|     |.......................................|     |
|     |.......................................|     |
|     |.......................................|     |
|     |............|------+------|............|     |
|     |............|      #      |............|     |
|     |............| |----+----| |............|     |
|     |............| |.........| |............|     |
|     |............| |.........| |............|     |
|     |............| |.........| |............|     |
|     |............| |.........| |............|     |
|     |............+#+.........+#+............|     |
|     |............| |.........| |............|     |
|     |............| |.........| |............|     |
|     |............| |.........| |............|     |
|     |............| |.........| |............|     |
|     |............| |.........| |............|     |
|     |............| |----+----| |............|     |
|     |............|      #      |............|     |
|     |............|------+------|............|     |
|     |.......................................|     |
|     |.......................................|     |
|     |-----------|...............|-----------|     |
|                 |...............|                 |
|                 |---------------|                 |
|                                                   |
|---------------------------------------------------|