|------------------------------------------------------------------------------------------|
|                                                                                          |
|   |----------|      |----------|      |----------|      |----------|      |----------|   |
|   |..........|      |..........|      |..........|      |..........|      |..........|   |
|   |..........|      |..........|      |..........|      |..........|      |..........|   |
|   |..........|      |..........|      |..........|      |..........|      |..........|   |
|   |..........|      |..........|      |..........|      |..........|      |..........|   |
|   |..........|      |..........|      |..........|      |..........|      |..........|   |
|   |----------|      |----------|      |----------|      |----------|      |----------|   |
|                                                                                          |
|                                                                                          |
|                                                                                          |
|   |----------|      |----------|      |----------|      |----------|      |----------|   |
|   |..........|      |..........|      |..........|      |..........|      |..........|   |
|   |..........|      |..........|      |..........|      |..........|      |..........|   |
|   |..........|      |..........|      |..........|      |..........|      |..........|   |
|   |..........|      |..........|      |..........|      |..........|      |..........|   |
|   |..........|      |..........|      |..........|      |..........|      |..........|   |
|   |----------|      |----------|      |----------|      |----------|      |----------|   |
|                                                                                          |
|                                                                                          |
|                                                                                          |
|   |----------|      |----------|      |----------|      |----------|      |----------|   |
|   |..........|      |..........|      |..........|      |..........|      |..........|   |
|   |..........|      |..........|      |..........|      |..........|      |..........|   |
|   |..........|      |..........|      |..........|      |..........|      |..........|   |
|   |..........|      |..........|      |..........|      |..........|      |..........|   |
|   |..........|      |..........|      |..........|      |..........|      |..........|   |
|   |----------|      |----------|      |----------|      |----------|      |----------|   |
|                                                                                          |
|                                                                                          |
|                                                                                          |
|   |----------|      |----------|      |----------|      |----------|      |----------|   |
|   |..........|      |..........|      |..........|      |..........|      |..........|   |
|   |..........|      |..........|      |..........|      |..........|      |..........|   |
|   |..........|      |..........|      |..........|      |..........|      |..........|   |
|   |..........|      |..........|      |..........|      |..........|      |..........|   |
|   |..........|      |..........|      |..........|      |..........|      |..........|   |
|   |----------|      |----------|      |----------|      |----------|      |----------|   |
|                                                                                          |
|------------------------------------------------------------------------------------------|
