|-------------------|
|.........|.........|
|.........|.........|
|.........#.........|
|.........#.........|
|.........|.........|
|.........|.........|
|-------------------|
|-------------------|
|.........|.........|
|.........|.........|
|.........#.........|
|.........#.........|
|.........|.........|
|.........|.........|
|-------------------|
|-------------------|
|.........|.........|
|.........|.........|
|.........#.........|
|.........#.........|
|.........|.........|
|.........|.........|
|-------------------|
|-------------------|
|.........|.........|
|.........|.........|
|.........#.........|
|.........#.........|
|.........|.........|
|.........|.........|
|-------------------|
|-------------------|
|.........|.........|
|.........|.........|
|.........#.........|
|.........#.........|
|.........|.........|
|.........|.........|
|-------------------|