|-----------------------------------|
|                                   |
| |-----------|       |-----------| |
| |.D9.D9.....|       |....E.....\| |
| |.........M.+#######+.M.........| |
| |@..8..8....|       |......W....| |
| |-----------|       |-----------| |
|                                   |
|-----------------------------------|
|-----------------------------------|
|                                   |
| |-----------|       |-----------| |
| |.D9.D9.....|       |....E.....\| |
| |.........M.+#######+.M.........| |
| |@..8..8....|       |......W....| |
| |-----------|       |-----------| |
|                                   |
|-----------------------------------|
|-----------------------------------|
|                                   |
| |-----------|       |-----------| |
| |.D9.D9.....|       |....E.....\| |
| |.........M.+#######+.M.........| |
| |@..8..8....|       |......W....| |
| |-----------|       |-----------| |
|                                   |
|-----------------------------------|
|-----------------------------------|
|                                   |
| |-----------|       |-----------| |
| |.D9.D9.....|       |....E.....\| |
| |.........M.+#######+.M.........| |
| |@..8..8....|       |......W....| |
| |-----------|       |-----------| |
|                                   |
|-----------------------------------|
|-----------------------------------|
|                                   |
| |-----------|       |-----------| |
| |.D9.D9.....|       |....E.....\| |
| |.........M.+#######+.M.........| |
| |@..8..8....|       |......W....| |
| |-----------|       |-----------| |
|                                   |
|-----------------------------------|